First line: #rows, #columns, optional delay, optional chamber size. Other lines: U-free, W-wall, D-dragon, L-lava, C-Cacti, S-Initial, E-Exit
20 20
W W S W W W U D U W W W W W W W U U U W
 W U U U W U U U U W W U U U W D D D D W
W U W U U W W U U U W U W U U D W D W D
 W U W U W W U U W U W U W U W D W W D W
W U W U U U U W U W U U W U U U D W D W
 W U W U W W U W D W W U W U W W D D U W
W U W U W W W U W W W U W U W W W D W W
 W U W U U W U U W W W U W U U W U U W W
W U W W U U U W U W W U W W U U U W U W
 W U U U W U U U U W W U U U W U U U U W
W W U W W W U U U W W W U W W W U U U W
 W U U U W U U D U W W U U D W U U D U W
W D W U U W W U U W W U W U U W W U U W
 W U W U W W U D W W W U W U W W U U W W
W U W U U U U W U W W U W U W U U W U W
 W U W U W W U W U W W U W U W W U W U W
W U W U W W W U W W W U U U W W W U W W
 W U W U D W U U U U U U W U U W U W W W
W D U W U U U W U W W U W W U U E W U W
 W U U U W U U U U W W D U U W U U U D W